+-+-+-+-+-+-+-+-+-+-+
|   |     |         |
+ + + + + +-+-+-+ + +
| | | | |       | | |
+ + +-+ +-+-+-+ +-+ +
|   |   |   |   |   |
+ +-+ +-+ +-+ +-+ +-+
| |   |   |   |     |
+ + +-+ +-+ +-+-+-+ +
| | |           |   |
+ + + +-+ +-+-+ + + +
|   |     |   |   | |
+-+-+-+-+ + + +-+-+ +
|         | |     | |
+-+ + +-+-+ + +-+-+ +
|   | |     | |   | |
+ + +-+ +-+-+ + + + +
|     |     | | | | |
+ +-+ +-+-+ + + + + +
|           |   |   |
+-+-+-+-+-+-+-+-+-+-+
